0000000000
0111101110
0100101010
1100111011
01000t0010
0111110110
0000010000
0111010010
0101111110
0000000000
start:3,0
end:3,9
