0010000010
0111101110
0100101010
1100111011
01010t0010
0111110110
0000010100
0111010011
1101111110
1001000100
start:3,0
end:3,9
